8, 6
-1, -1, -1, -1, -1, -1
-1,  3,  7, -1, -1, -1
-1,  1,  1,  0,  3, -1
-1,  0,  2,  0, -1, -1
-1, -1,  0,  1,  3, -1
-1,  3,  1,  0,  0, -1
-1, -1,  3,  1,  6, -1
-1, -1, -1, -1, -1, -1